% Set up 
0,0 1,1,L,_
0,1 1,2,L,_
0,2 1,3,L,_
0,3 1,4,_,R

% Main body
1,0 2,_,_,R
2,0 3,_,_,R
3,0 0,_,R,R

% Stop
4,0 4,4,_,_
4,4 4,4,_,_
