0 0 1 _ _ U
1 0 2 1 _ D
2 2 0 1 _ R
2 0 3 1 _ D
0 1 1 _ D R
1 1 1 _ R R
3 0 1 2 D L
2 1 3 1 _ L
3 1 2 1 _ L
4 0 1 1 _ R
0 4 1 1 U R
4 1 1 1 U L
1 2 2 1 L R
0 2 4 1 D U