0,0 1,1,L,_
0,1 1,2,L,_
0,2 1,3,L,_
0,3 1,4,L,_
0,4 1,5,L,_