0,0 4,1,_,D
0,1 _,2,L,R
0,2 2,2,D,L
0,3 3,1,D,L
0,4 1,1,_,R
1,0 1,4,D,U
1,1 4,2,U,R
1,2 1,2,R,U
1,3 3,4,L,D
1,4 _,4,L,R
2,0 2,_,D,_
2,1 _,3,L,U
2,2 2,_,L,R
2,3 3,3,D,L
2,4 4,3,_,D
3,0 1,3,D,L
3,1 1,4,D,R
3,2 4,1,L,_
3,3 1,4,_,U
3,4 _,4,_,R
4,0 2,3,_,U
4,1 _,_,_,L
4,2 4,3,D,_
4,3 4,3,R,L
4,4 _,1,U,_
