%Set up (move Alice and Bob 80 positions down)



% will take bob x * y positions, in this case 3 * 2 = 6)
0,0 1,1,U,_
0,1 1,_,_,_
1,1 2,_,_,_
2,1 3,_,_,_
3,1 4,_,_,_
4,1 _,2,U,_

0,2 1,_,_,_
1,2 2,_,_,_
2,2 3,_,_,_
3,2 4,_,_,_
4,2 _,3,U,_

0,3 1,_,_,_
1,3 2,_,_,_
2,3 3,_,_,_
3,3 4,_,_,_
4,3 _,4,U,_


0,4 1,_,_,_
1,4 2,_,_,_
2,4 3,_,_,_
3,4 4,_,_,_
4,4 _,0,_,_

4,0 3,1,_,_
3,0 2,2,_,_
2,0 1,3,_,_
1,0 0,4,D,_

