0,0 1,_,_,L
0,1 4,2,L,_
0,2 1,1,L,D
0,3 1,1,D,R
0,4 3,_,U,_
1,0 2,2,R,R
1,1 1,3,D,D
1,2 2,2,R,_
1,3 2,_,R,R
1,4 2,4,U,U
2,0 1,4,D,R
2,1 _,4,D,U
2,2 3,3,D,R
2,3 1,_,_,D
2,4 1,2,L,U
3,0 3,3,_,D
3,1 1,1,R,D
3,2 3,_,D,R
3,3 3,_,_,R
3,4 4,4,D,_
4,0 4,2,L,_
4,1 3,4,D,L
4,2 2,3,R,U
4,3 4,1,R,U
4,4 _,4,D,R
