0,0 _,1,_,R
0,1 3,3,D,_
0,3 2,2,R,_
2,3 _,_,R,_
0,2 _,1,U,_
1,1 _,_,L,_
3,1 0,3,R,R
1,0 _,1,R,R
3,0 _,1,L,_
1,2 2,_,_,D
2,0 3,_,_,D
2,1 _,_,_,_
2,2 3,3,_,D
