
0,0 2,1,D,_

0,2 _,_,U,L
2,0 2,2,_,R
2,2 1,0,R,R

2,1 _,_,D,L
