%Set up (move Alice and Bob 80 positions down)



% will take bob x * y positions, in this case 3 * 2 = 6)
0,0 2,2,U,_
0,2 2,3,U,_
0,3 2,4,U,_
0,4 2,5,U,_
0,5 2,6,U,_
0,6 2,7,U,_
0,7 2,8,_,D


2,0 3,_,_,D
3,0 4,_,_,D
4,0 5,_,_,D
5,0 6,_,_,D
6,0 7,_,_,D
7,0 8,_,D,D

% move down
8,0 8,8,_,U
8,8 8,8,R,R

% Halt
0,1 2,2,_,_
1,1 2,2,_,_
2,1 2,2,_,_
3,1 2,2,_,_
4,1 2,2,_,_
5,1 2,2,_,_
6,1 2,2,_,_
7,1 2,2,_,_
8,1 2,2,_,_
2,2 _,_,_,_

