0,0 0,1,D,_
0,1 2,_,_,_

2,1 3,3,R,_
0,3 3,_,_,R
3,0 2,1,_,_
3,1 _,_,_,L
3,3 _,_,_,L
