%go down 3, up 3, right 1

%down loop
0,0 1,2,_,D
1,0 2,2,_,D
2,0 3,2,_,D

%up loop
3,0 2,_,_,U
2,2 1,_,_,U
1,2 3,3,_,U

%move right
3,3 0,_,_,R
3,2 0,_,_,R

%change 1 to a 2
0,1 0,2,_,_
1,1 0,2,_,_
2,1 0,2,_,_
3,1 0,2,_,_

%halt
0,2 _,_,_,_
