0,0 4,4,_,R
4,0 _,2,_,R
4,1 _,_,D,_
0,1 _,3,R,_
0,3 3,5,U,_
3,3 _,3,R,_
3,1 _,_,R,_
4,5 _,_,R,R
2,0 1,2,R,R
5,0 _,1,L,_
1,1 2,_,L,_
2,5 _,_,L,_
5,5 _,_,L,_
1,3 _,_,_,D
1,0 2,4,D,_
0,4 _,_,U,_
2,4 3,_,_,D
3,0 2,1,_,_
2,1 _,_,_,_
3,2 _,_,_,D
0,2 3,_,_,D