%go down 3, up 3, right 1

%down loop
0,0 0,1,D,_
0,1 _,2,D,_
0,2 _,_,U,_
2,2 0,0,R,R

1,0 2,_,_,U
1,1 2,_,_,U
1,2 2,_,_,U

2,0 _,_,_,_

