0,0 2,2,_,R
2,0 _,1,_,R
2,1 _,_,R,R
1,0 2,1,D,_
0,1 _,_,U,_
1,1 3,_,_,D
3,0 3,3,L,_
0,3 2,_,R,D
2,3 3,1,_,_
3,1 _,_,_,_

