0,0 3,3,_,D
3,0 _,1,_,R

3,1 _,2,R,D
0,2 2,3,L,_
2,2 _,_,R,_
2,3 _,_,L,_

3,3 _,0,D,_
1,0 _,2,R,R
1,3 _,_,L,_
0,3 _,2,R,_
1,2 _,1,U,_
0,1 2,_,_,D
2,0 _,3,L,_
2,1 _,_,_,_
