0,0 2,2,D,_
0,2 2,_,_,D
2,2 _,_,_,R
2,3 _,_,_,R
2,0 _,1,_,R
2,1 _,_,D,_
0,1 3,_,_,D
3,0 4,2,_,L
4,0 _,3,_,L
4,4 2,_,_,R
4,1 _,_,_,R
4,3 _,_,_,R
4,2 _,1,D,_
1,1 _,_,_,D
1,0 5,1,_,_
5,1 _,_,_,_
3,1 _,_,D,_



