0,0 2,1,R,L
0,1 _,_,R,R
1,1 _,_,R,R
1,0 _,1,R,R
0,2 1,3,_,_
1,3 _,_,_,_