0,0 _,_,_,D

0,1 5,5,D,_
0,5 5,5,_,R
5,0 2,2,R,_
5,1 2,2,R,_



0,2 2,_,_,R
2,0 _,2,R,_
2,1 _,2,R,_
2,4 _,4,R,_

1,2 1,4,_,D


1,0 6,5,_,U
1,5 _,_,_,D
6,5 _,_,_,U
6,4 5,1,L,L

%1,3
2,2 0,1,L,L

2,5 0,_,D,_

5,5 6,6,D,_
6,2 _,6,D,_

0,6 6,2,R,_
5,2 4,_,_,R
5,4 4,6,_,R
4,1 _,4,L,L
4,4 _,4,L,L
0,4 6,6,_,R
6,1 _,4,R,_
6,6 0,1,L,L
2,6 0,1,L,L
6,0 4,_,_,L
4,6 _,0,_,L
4,2 _,_,_,R
4,0 _,1,_,U
4,5 _,_,_,_
