0,0 _,_,_,D

0,1 0,2,D,_
0,2 2,_,_,R
2,0 2,2,R,_


0,5 5,5,_,R
5,0 2,2,R,_
5,1 2,2,R,_



%0,2 2,_,_,R
%2,0 _,2,R,_
2,1 1,0,_,L

1,2 _,1,L,_
%2,2 1,1,_,L

2,5 _,_,D,_

5,5 _,_,_,_