0,0 2,_,_,D
2,0 3,3,_,R
3,0 4,4,_,U
4,0 5,5,_,L
5,0 2,2,_,D

2,4 3,_,_,R
3,5 4,_,_,U
4,2 5,_,_,L
5,3 2,_,_,D

5,5 3,2,_,R
4,4 2,5,_,D
2,2 4,3,_,U
3,3 5,4,_,L

% Halt
0,1 0,2,_,_
1,1 0,2,_,_
2,1 0,2,_,_
3,1 0,2,_,_
4,1 0,2,_,_
5,1 0,2,_,_
0,2 _,_,_,_