0,0 2,_,_,D
2,0 3,3,_,R
3,0 4,4,_,U
4,0 1,2,_,L
1,0 2,2,_,D
2,3 _,_,_,D

2,4 3,_,_,R
3,2 4,4,_,U
4,2 1,_,_,L
1,3 2,_,_,D

1,1 0,3,_,_
4,4 2,2,_,D
2,2 4,3,_,U
3,3 1,4,_,L
1,4 3,2,_,R
1,2 3,2,_,R

