0,0 4,4,_,D
4,0 _,1,_,R

4,1 _,2,R,_
0,2 2,3,L,_
2,2 _,_,R,_
2,3 _,_,L,_

4,3 _,0,D,_
1,0 _,3,R,R
3,0 _,3,L,_
1,3 _,_,L,_
0,3 _,2,R,_
1,2 _,1,U,_
0,1 2,_,_,D
2,0 2,1,_,_
2,1 _,_,_,_
